

NO ./Includes/assets/wall .xpm
SO ./Includes/assets/wall2.xpm
WE ./Includes/assets/wall3.xpm
EA ./Includes/assets/wall4.xpm


F 5,23,45

C 255,255,0

111111111111111111111111
100000000000000000000001
111111111111101111111111
111111111111101111111111
100000000000000000000001
100000000000000000000001
100000000000000000000001
100000000000000000000001
10000000000000000000N001
111111111111111111111111
