

NO ./Includes/assets/wall  .xpm
SO ./Includes/assets/wall2.xpm
WE ./Includes/assets/wall3.xpm
EA ./Includes/assets/wall4.xpm


F 225     ,    23  ,   45

C 255,255,255

1111
1N00
1111

