

NO ./Includes/assets/512/wall1.xpm
SO ./Includes/assets/512/wall2.xpm
WE ./Includes/assets/512/wall3.xpm
EA ./Includes/assets/512/wall4.xpm
CD ./Includes/assets/512/door.xpm
OD ./Includes/assets/512/door_open.xpm

SPRITE M 5 ./Includes/assets/coins/
SPRITE WALL 1 ./Includes/assets/map/wall
SPRITE DOOR 1 ./Includes/assets/map/door
SPRITE VOID 1 ./Includes/assets/map/void
SPRITE PLAYER 2 ./Includes/assets/map/player

F 11,11,11
C 200,200,200


111111111111111111111111
1M0M0M0M0M0M0M0M0M0M0M01
100000000000000000000001
1M00000000000000000000M1
100000111110000101010001
1M00001000100000000000M1
100000100010000100010001
1M00001000100000000000M1
100000110110000101010001
1M00000000000000000000M1
100000000000000000000001
1M00000000000000000000M1
100000000000000000000001
1M00000000000000000000M1
100000000000000000000001
1M0M0M0M00000000000000M1
111111D11000000000000001
110100001M000000000000M1
11000000D000000000000001
110100001M000000000000M1
110111111000000000000001
110M0M0M0000000000N000M1
1111111110M0M0M0M0M0M001
111111111111111111111111
2