
NO ./Includes/assets/1024/wall3.xpm
SO ./Includes/assets/1024/wall4.xpm
WE ./Includes/assets/1024/wall5.xpm
EA ./Includes/assets/1024/wall6.xpm
CD ./Includes/assets/1024/Door-1-close.xpm
OD ./Includes/assets/1024/Door-1-open.xpm

SPRITE M 10 ./Includes/assets/coins/
SPRITE WALL 1 ./Includes/assets/map/wall
SPRITE DOOR 1 ./Includes/assets/map/door
SPRITE VOID 1 ./Includes/assets/map/void
SPRITE PLAYER 2 ./Includes/assets/map/player

F 26,8,112
C 200,200,200

11111111111111111111111111111111111111111111111111111111111111111111111111111111111111111111111
1M0M0M0M0M0M00000000000000000000000000000000000000100000000000000000000000000000000000000000001
11111111111111011111111100000000000000000000000000100000000000000000000000000000000000000000001
1M0M0M0M0M0M0M0M0M0M0M01M0000000000000000000000000100000000000000000000000000000000000000000001
10000000000000000000000111111111111000000000000000100000000000000000000010000000000000000000001
1M00000000000000000000M100000000001000000000000000100000000000000000000111000000000000000000001
1000001111100001010100010M000000M01000000000000000100000000000000000001111100000000000000000001
1M00001000100000000000M10000000000D000000000000000100000000000000000011111110000000000000000001
10000010001000010001000100000000001000000000000000100000000000000000111111111000000000000000001
1M00001000100000000000M100000000001000000000000111100000000000000001111111111100000000000000001
10000011011000010101000100000000001000000000000111100000000000000011111111111110000000000000001
1M00000000000000000000M100000000001000000000000111100000000000000111111111111111000000000000001
10000000000000000000000111111111111111111000000000100000000000000011111111111110000000000000001
1M00000000000000000000M100000000001111111000000000000000000000000001111111111100000000000000001
10000000000000000000000100000000001111111000000000100000000000000000111111111000000000000000001
1M00000000000000000000M100000000000000000000000111100000000000000000011111110000000000000000001
10000000000000000000000100000000000000000000000111100000000000000000001111100000000000000000001
1M0M0M0M00000000000000M100000000000000000000000111100000000000000000000111000000000000000000001
111111D1100000000000000100000000001111111000000000100000000000000000000010000000000000000000001
1101M00M1M000000000000M100000000001111111000000000100000000000000000000000000000000000000000001
11000000D00000000000000111111111111111111111111110100000000000000000000000000000000000000000001
1101M00M1M000000000000M100000000000000000000000000100000000000000000000000000000000000000000001
1101111110000000000N000100000000000000000000000000100000000000000000000000000000000000000000001
110M0M0M00000000000000M100000000000000000000000000100000000000000000000000000000000000000000001
1111111110M0M0M0M0M0M00100000000000000000000000000100000000000000000000000000000000000000000001
11111111100000000000000100000000000000000000000000100000000000000000000000000000000000000000001
11111111111111111111111111111111111111111111111111111111111111111111111111111111111111111111111
